2,0,0,2,0,2,0,2,0,0,1,0
0,2,0,0,2,3,2,0,1,0,0,2
0,0,2,0,0,0,0,1,0,0,2,0
2,1,4,4,0,0,2,0,0,0,0,0
2,0,0,0,0,2,0,2,6,6,6,6
0,0,2,0,1,0,2,0,6,3,0,0
0,0,0,2,0,0,0,0,6,0,7,0






