0,2,0,0,0,3,0,6,0,0,0,0
2,3,1,1,1,2,0,6,1,0,2,0
0,2,1,0,2,0,2,6,0,2,0,1
4,4,2,0,3,2,2,6,2,0,1,3
1,0,2,2,0,2,1,6,1,3,2,7
1,1,0,2,2,1,0,6,0,0,2,2
0,0,1,0,0,0,2,6,0,3,0,1