8,8,8,8,8,8,8,8,8,8,8,8
8,8,8,8,8,8,8,8,8,8,8,8
8,8,8,8,8,8,8,8,8,8,8,8
8,4,4,4,0,2,2,3,2,0,8,8
8,0,0,0,2,0,1,6,7,0,8,8
8,8,8,8,8,8,8,8,8,8,8,8
8,8,8,8,8,8,8,8,8,8,8,8







