0,3,0,0,0,0,0,0,0,6,6,1
7,0,0,0,0,1,0,6,6,6,6,6
0,3,0,0,0,6,6,6,6,6,6,6
9,9,9,9,9,9,9,6,6,6,6,6
0,0,0,0,0,6,6,6,6,1,6,6
1,0,0,0,0,0,0,6,6,6,6,6
4,4,4,0,1,0,6,6,6,6,6,6






