0,3,1,0,0,0,0,0,2,6,6,1
7,2,0,0,0,1,0,6,6,1,6,6
0,3,0,2,9,9,6,6,6,6,6,6
9,9,9,9,9,0,9,9,6,6,6,1
0,1,2,0,1,0,6,9,6,1,6,6
1,0,0,0,0,2,0,6,1,6,6,6
4,4,4,0,1,0,6,6,1,6,6,1






