0,0,0,0,0,2,0,0,0,0,0,0
0,0,0,0,2,1,2,0,0,0,0,0
0,0,0,2,1,2,1,2,0,6,0,0
0,4,4,4,0,3,0,0,6,7,6,0
0,0,0,2,1,2,1,2,0,6,0,0
0,0,0,0,2,1,2,0,0,0,0,0
0,0,0,0,0,2,0,0,0,0,0,0






