0,0,0,1,0,0,0,1,6,0,0,1
0,1,0,0,3,0,1,6,6,6,2,0
0,2,0,0,1,0,6,6,1,6,6,0
2,4,4,4,0,6,6,0,3,0,6,6
0,1,0,1,0,1,6,6,2,6,6,0
1,0,0,0,0,0,1,6,6,6,0,3
0,2,0,1,0,1,0,0,6,1,7,0


