0,0,1,0,1,2,0,1,0,1,0,0
2,0,0,2,0,0,0,0,3,0,1,0
0,6,6,6,6,0,1,0,2,7,0,0
0,4,4,4,6,0,3,2,3,2,3,0
6,6,6,6,6,0,0,0,2,0,0,0
2,0,0,0,2,0,0,1,3,1,0,0
0,0,2,1,0,0,0,0,0,0,0,0






