3,1,6,6,1,6,6,6,6,6,2,2
1,2,2,1,3,1,2,6,1,6,6,2
6,2,2,1,1,6,6,1,3,2,6,6
6,4,4,4,3,6,6,6,1,6,6,6
6,6,6,6,1,1,6,6,6,6,1,6
2,6,6,6,1,3,1,6,6,1,3,1
3,2,6,6,6,1,6,6,6,6,1,7






