0,0,0,0,0,2,0,0,0,0,0,0
0,0,0,0,2,1,2,0,0,0,0,0
0,0,0,2,1,2,0,2,0,0,0,0
0,0,4,4,0,3,0,0,2,0,0,0
0,0,0,2,1,2,2,2,0,0,0,0
0,0,0,0,2,6,7,0,0,0,0,0
0,0,0,0,0,2,0,0,0,0,0,0






