1,6,6,6,1,6,6,6,6,6,6,6
6,6,6,1,3,1,2,6,1,6,6,6
6,6,6,6,1,6,6,1,3,1,6,6
6,4,4,4,3,1,6,6,1,9,9,6
6,1,6,6,1,6,6,6,9,9,3,1
2,3,1,6,6,1,6,9,9,3,1,6
6,6,6,6,6,3,9,9,7,1,1,6






