4,4,4,0,6,6,2,0,6,6,6,2
1,3,0,6,6,0,3,6,6,6,1,0
0,0,6,6,3,1,6,6,6,0,3,1
1,6,6,2,1,6,6,6,3,1,6,6
6,6,1,3,6,6,6,0,2,6,6,0
1,0,0,6,6,6,3,1,6,6,1,3
2,1,6,6,6,0,1,6,6,3,0,7






