0,0,0,0,0,0,0,0,0,0,0,0
0,0,0,0,0,2,0,0,0,0,0,0
0,2,2,2,3,2,2,0,0,0,0,0
0,2,4,4,0,2,2,3,2,0,0,0
0,2,2,2,2,2,1,6,7,0,0,0
0,2,2,2,2,2,0,0,0,0,0,0
0,0,0,0,0,0,0,0,0,0,0,0





