0,0,1,0,1,2,0,6,6,6,0,0
2,0,0,2,0,0,6,6,3,6,1,0
0,0,3,1,0,6,6,0,2,6,3,0
6,4,4,4,6,6,3,2,3,6,0,0
0,0,0,6,6,0,1,0,2,6,3,0
1,0,6,6,2,0,0,1,3,6,0,1
0,6,6,1,0,0,1,0,1,6,0,7






