0,0,0,0,0,2,0,0,0,0,0,0
2,0,0,2,0,0,0,0,3,0,1,0
0,0,0,0,0,0,1,0,2,0,0,0
0,0,4,4,2,0,3,2,7,2,3,0
6,0,2,0,0,0,0,0,2,0,0,0
2,0,0,0,2,0,0,1,3,1,0,0
0,0,2,0,0,0,0,0,0,0,0,0


